###
#.#
#$#
# ####
#@ * #
# ####
#$#
#.#
###
,
########
#     .#
# # ####
#   #
###$#
  # #
  #@#
  ###
,
    #####
    #   #
    #$  #
  ###  $##
  #  $ $ #
### # ## #   ######
#   # ## #####  ..#
# $  $          ..#
##### ### #@##  ..#
   ##     #########
   ########
,
